11111111111111111111111111111111111111111111111111
10000000000000000000000000000000000000000000000001
10000000000000000000000000000000000000000000000001
10000000000000000000000000000000000000000000000001
10000000000000000000000000000000000000000000000001
10000000000000000000000000000000000000000000000001
10000000000000111111111111111111111110000000000001
10000000000000100000000000010000000210000000000001
10000000000000100000000000010000000010000000000001
10000000000000100002000000010000300010000000000001
10000000000000100000000000010000300010000000000001
10000000000000100000000000010000300010000000000001
10000000000000100000000000011111001110000000000001
10000000000000100000000000000000000010000000000001
10000000000000100000000000000000000010000000000001
10000000000000100000111111111111111110000000000001
10000000000000100000000000000000000010000000000001
10000000000000100000000000000000000010000000000001
10000000000000111111111000111111111110000000000001
10000000000000000000000000000000000000000000000001
10000000000000000000000000000000000000000000000001
10000000000000000000000000000000000000000000000001
10000000000000000000000000000000000000000000000001
10000000000000000000000000000000000000000000000001
11111111111111111111111111111111111111111111111111
102
101
-1
103