11111111111111111111111111111111111111111111111111
10000000000000000000000000000000000000000000000001
10000000000000000000000000000000000000000000000001
10000000000000000000000000000000000000000000000001
10000000000001111100000011111110000000000000000001
10000000000000100000000000000011111111100000000001
10000000000000010000000000000010000000000000000001
10000000000000001000000000000010000000000000000001
10000000000000000100000000000010000000111111111111
10000000000000000010000000000010000000000000000001
10000000000000000001000003000010000000000000000001
10000000000000000000100000000010000000000000000001
10000000000000000000010000000011111111111100000001
10000000000000000000001111111110000000000000000001
10000000000000000000000000000000000000000000000001
10000000000000000000000000000000000000000000000001
10000000000000000000000000000000000000000000000001
10000000000000000000001111001111111111111110000001
10000000000000000000010000000010000000000000000001
10000000000000000000100002000010000000000000000001
10000000000000000001000000000010000000000000000001
10000000000000001111111111111110000111111111111111
10000000000000000000000000000000000000000000000001
10000000000000000000000000000000000000000000000001
11111111111111111111111111111111111111111111111111
-1
104
-1
100