11111111111111111111111111111111111111111111111111
10000000000000000000000000000000000000000000000001
10000000000000000000000000000000000000000000000001
10000000000000000000000000000000000000000000000001
10000000000001111100000011111110000000000000000001
10000000000000100000000000000010000000000000000001
10000000000000010000000000000010000000000000000001
10000000000000001000000000000010000000000000000001
10000000000000000100000000000010000000000000000001
10000000000000000010000000000010000000000000000001
10000000000000000001000003000010000000000000000001
10000000000000000000100000000010000000000000000001
10000000000000000000010000000010000000000000000001
10000000000000000000001111111110000000000000000001
10000000000000000000000000000000000000000000000001
10000000000000000000000000000000000000000000000001
10000000000000000000000000000000000000000000000001
10000000000000000000000000000000000000000000000001
10000000000000000000000000000000000000000000000001
10000000000000000000000000000000000000000000000001
10000000000000000000000000000000000000000000000001
10000000000000000000000000000000000000000000000001
10000000000000000000000000000000000000000000000001
10000000000000000000000000000000000000000000000001
11111111111111111111111111111111111111111111111111
-1
-1
-1
100