11111111111111111111111111111111111111111111111111
10000000000000000010000000000000100000000000000001
10000000000000000010000000000000100000000000000001
10000000000000000010000000000000100000000000000001
10000000200000000010000000000000100000000002000001
10000000000000000010000000000000100000000000000001
10000000000000000010000000000000100000000000000001
10000000000000000010000000000000100000000000000001
11111111100011111110000000000000111111111000111111
10000000000000000000000000000000000000000000000001
10000000000000000000000000000000000000000000000001
10000000000000000000000000000000000000000000000001
10000000000000000000000000000000000000000000000001
10000000000000000000000003000000000000000000000001
10000000000000000000000000000000000000000000000001
10000000000000000000000000000000000000000000000001
10000000000000000000000000000000000000000000000001
10000000000000000000000000000000000000000000000001
10000000000000000000000000000000000000000000000001
11111111100011111110000000000000011111111000111111
10000000000000000010000000000000010000000000000001
10000000000000000010000000000000010000000000000001
10000000020000000010000000000000010000000020000001
10000000000000000010000000000000010000000000000001
11111111111111111111111111111111111111111111111111
-1
-1
100
-1