11111111111111111111111111111111111111111111111111
10000100000000000000000000000000000001000000000001
10020100000011111111111111111111000001000000000001
10000100000010000000000000002001000001000011111111
10000100000010000000000300000001000000000000000001
10000000000000000000000000002001000000000000000001
11111111111111111111111111111111111111111100000001
10000000000000000000110000000000000000000100010001
10000000000000000000110000000000000000000100010001
10000000010000000000110000000000100000000100010201
10002000010000000000000000000000100002000100010001
11111111111111111110000000000000100000000100011111
10000000000000000010000111111111111111111100000001
10000000000000000010000100000000000000000100000001
10000000000000000010000100000000000000000100000001
10000000000000000010000100000100000100000100011111
11111111111111100010000100000100000100200100000001
10000000000000100010000000000100000100000100000001
10000000000000100010000000000100000111111100010001
10000000001000100011111111111000000000000000010001
10000000001000100010000000000000000000000000010001
10000000001000100000111111111111111111111111110001
10000300001000111111100000000000000000000000000001
10000000001000000000000000000000000000000000000001
11111111111111111111111111111111111111111111111111
-1
100
-1
-1