11111111111111111111111111111111111111111111111111
11000000000000000000000000000000000000000000000011
10100000000000000000000000000000000000000000000101
10010000000000000111111111111111110000000000001001
10001000000000000000000000000000000000000000010001
10000100000000000000000000000000000000000000100001
10000010000000000000000000000000000000000001000001
10000001000000000000000000000000000000000100000001
10000000000000000000000000000000000000000000000001
10000000000000000000000000000000000000000000000001
10000000000000000000000000000000000000000000000001
10000000000000000000000000000000000000000000000001
10000000000000000000000000000000000000000000000001
10000000000000000000000000000000000000000000000001
10000000000000000000000000000000000000000000000001
10000000000000000000000000000000000000000000000001
10000000000000000000000000000000000000000000000001
10000001000000000000000000000000000000000010000001
10000010000000000000000000000000000000000001000001
10000100000000000000000000000000000000000000100001
10001000000000000011111111111111111100000000010001
10010000000000000000000000000000000000000000001001
10100000000000000000000000000000000000000000000101
11000000000000000000000000000000000000000000000011
11111111111111111111111111111111111111111111111111
-1
-1
-1
101