00000000000000000000000040000000000000000000000000
01111111111111111111111111111111111111111111111110
01111111111111111111111111111111111111111111111110
01111111111111111111111111111111111111111111111110
01111111111111111111111111111111111111111111111110
01111111111111111111111111111111111111111111111110
01111111111111100000000000000000000001111111111110
01111111111111101111111112021111111101111111111110
01111111111111101111111111011111111101111111111110
01111111111111101111111111011111111101111111111110
01111111111111101111111111011111111101111111111110
01111111111111101100000000000000001101111111111110
01111111111111101111111111111111111101111111111110
41111111111111101111111111111111111101111111111114
01111111111111101111111111111111111101111111111110
01111111111111100000000001110000000001111111111110
01111111111111101111111111111111111101111111111110
01111111111111101111111111111111111101111111111110
01111111111111101111111111111111111101111111111110
01111111111111100000000001110000000001111111111110
01111111111111111111111111111111111111111111111110
01111111111111111111111111111111111111111111111110
01111111111111111111111111111111111111111111111110
01111111111111111111111111111111111111111111111110
00000000000000000000000000000000000000000000000000
X
Map_TwoRoom
X
X


