00000000000000000000000000000000000000000000000000
01111111111111111111111111111111111111111111111110
01111111111111111111111111111111111111111111111110
01110000000000000000000111111111111111111111111110
01110111111111111111110111111111111111111111111110
01110111111111111111110111111111111111111111111110
01110111111111111111110111111111111111111111111110
01110111111113111111110111111111111111111111111110
01110111111111111111110111111111111111111111111110
01110111111111111111110111111111111111111111111110
01110111111111111111110111111111111111111111111110
01111111111111111111110111111111111111111111111110
01111111111111111111110111111111111111111111111110
41110000000000000000000111111111111111111111111110
01111111111111111111111111111111111111111111111110
01111111111111111111111111000000000000000111011110
01111111111111111111111111011111111111111111011110
01111111111111111111111111011112111111111111011110
01111111111111111111111111011111111111111111011110
01111111111111111111111111011111111111111211011110
01111111111111111111111111011111111111111111011110
01111111111111111111111111011111111211111111011110
01111111111111111111111111000000000000000000011110
01111111111111111111111111111111111111111111111110
00000000000000000000000000000000000000000000000000
X
X
X
Map_Start